"filename", "language", "C", "Markdown", "C++", "comment", "blank", "total"
"d:\vscodeproject\Cyuyan\C_test_project\10_pointer\p.c", "C", 10, 0, 0, 29, 1, 40
"d:\vscodeproject\Cyuyan\C_test_project\11_struct\st.c", "C", 23, 0, 0, 7, 5, 35
"d:\vscodeproject\Cyuyan\C_test_project\1_datatype\main.c", "C", 1, 0, 0, 0, 0, 1
"d:\vscodeproject\Cyuyan\C_test_project\2_VariablesandConstants\main.c", "C", 18, 0, 0, 17, 2, 37
"d:\vscodeproject\Cyuyan\C_test_project\2_\main.c", "C", 0, 0, 0, 0, -1, -1
"d:\vscodeproject\Cyuyan\C_test_project\3_character_string\test.c", "C", 23, 0, 0, 6, 1, 30
"d:\vscodeproject\Cyuyan\C_test_project\4_Branch\practice_jishu.c", "C", 15, 0, 0, 1, 0, 16
"d:\vscodeproject\Cyuyan\C_test_project\4_Branch\test.c", "C", 33, 0, 0, 24, 0, 57
"d:\vscodeproject\Cyuyan\C_test_project\4_Branch\错误发现.md", "Markdown", 0, 10, 0, 0, 1, 11
"d:\vscodeproject\Cyuyan\C_test_project\5_loop_statement\main.c", "C", 4, 0, 0, 0, 0, 4
"d:\vscodeproject\Cyuyan\C_test_project\6_function\main.c", "C", 31, 0, 0, 1, 1, 33
"d:\vscodeproject\Cyuyan\C_test_project\7_operateor\main.c", "C", 10, 0, 0, 26, 3, 39
"d:\vscodeproject\Cyuyan\C_test_project\8_keyword\add.c", "C", 10, 0, 0, 8, 1, 19
"d:\vscodeproject\Cyuyan\C_test_project\8_keyword\kw.c", "C", 32, 0, 0, 41, 5, 78
"d:\vscodeproject\Cyuyan\C_test_project\9_define_and_macro\dam.c", "C", 11, 0, 0, 2, 0, 13
"d:\vscodeproject\Cyuyan\README.md", "Markdown", 0, -10, 0, 0, -1, -11
"d:\vscodeproject\Cyuyan\data_structure_exercise\Linklist_1\01.c", "C", -9, 0, 0, 0, -2, -11
"d:\vscodeproject\Cyuyan\leetcode\1.两数之和.c", "C", -19, 0, 0, -15, -3, -37
"d:\vscodeproject\Cyuyan\leetcode\9.回文数.c", "C", -37, 0, 0, -7, -2, -46
"d:\vscodeproject\Cyuyan\leetcode_project_exercise\leetcode_3_lengthOfLongestSubstring\zuichangzichuan.c", "C", -4, 0, 0, 0, 0, -4
"d:\vscodeproject\Cyuyan\leetcode_project_exercise\leetcode_9_isPalindrome\huiwen.c", "C", -37, 0, 0, 0, 0, -37
"d:\vscodeproject\Cyuyan\leetcode_project_exercise\leetcode_9_isPalindrome\huiwen.h", "C++", 0, 0, -1, -1, 0, -2
"d:\vscodeproject\Cyuyan\leetcode_project_exercise\leetcode_9_isPalindrome\huiwen1.c", "C", -12, 0, 0, -1, 0, -13
"d:\vscodeproject\Cyuyan\test1_hello\hello_world.c", "C", -15, 0, 0, 0, 0, -15
"d:\vscodeproject\Cyuyan\test1_hello\max.c", "C", -7, 0, 0, 0, 0, -7
"d:\vscodeproject\Cyuyan\test1_hello\max.h", "C++", 0, 0, -1, 0, 0, -1
"d:\vscodeproject\Cyuyan\test1_hello\min.c", "C", -7, 0, 0, 0, 0, -7
"d:\vscodeproject\Cyuyan\test1_hello\min.h", "C++", 0, 0, -1, 0, 0, -1
"Total", "-", 74, 0, -3, 138, 11, 220