"filename", "language", "C", "C++", "Markdown", "comment", "blank", "total"
"d:\vscodeproject\Cyuyan\C_test_project\1_datatype\main.c", "C", 11, 0, 0, 2, 0, 13
"d:\vscodeproject\Cyuyan\C_test_project\2_\main.c", "C", 0, 0, 0, 0, 1, 1
"d:\vscodeproject\Cyuyan\README.md", "Markdown", 0, 0, 10, 0, 1, 11
"d:\vscodeproject\Cyuyan\data_structure_exercise\Linklist_1\01.c", "C", 9, 0, 0, 0, 2, 11
"d:\vscodeproject\Cyuyan\leetcode\1.两数之和.c", "C", 19, 0, 0, 15, 3, 37
"d:\vscodeproject\Cyuyan\leetcode\9.回文数.c", "C", 37, 0, 0, 7, 2, 46
"d:\vscodeproject\Cyuyan\leetcode_project_exercise\leetcode_3_lengthOfLongestSubstring\zuichangzichuan.c", "C", 4, 0, 0, 0, 0, 4
"d:\vscodeproject\Cyuyan\leetcode_project_exercise\leetcode_9_isPalindrome\huiwen.c", "C", 37, 0, 0, 0, 0, 37
"d:\vscodeproject\Cyuyan\leetcode_project_exercise\leetcode_9_isPalindrome\huiwen.h", "C++", 0, 1, 0, 1, 0, 2
"d:\vscodeproject\Cyuyan\leetcode_project_exercise\leetcode_9_isPalindrome\huiwen1.c", "C", 12, 0, 0, 1, 0, 13
"d:\vscodeproject\Cyuyan\test1_hello\hello_world.c", "C", 15, 0, 0, 0, 0, 15
"d:\vscodeproject\Cyuyan\test1_hello\max.c", "C", 7, 0, 0, 0, 0, 7
"d:\vscodeproject\Cyuyan\test1_hello\max.h", "C++", 0, 1, 0, 0, 0, 1
"d:\vscodeproject\Cyuyan\test1_hello\min.c", "C", 7, 0, 0, 0, 0, 7
"d:\vscodeproject\Cyuyan\test1_hello\min.h", "C++", 0, 1, 0, 0, 0, 1
"Total", "-", 158, 3, 10, 26, 9, 206