"filename", "language", "Markdown", "C", "JSON", "comment", "blank", "total"
"d:\vscodeproject\Cyuyan\.VSCodeCounter\2024-05-20_23-33-24\details.md", "Markdown", 39, 0, 0, 0, 6, 45
"d:\vscodeproject\Cyuyan\.VSCodeCounter\2024-05-20_23-33-24\diff-details.md", "Markdown", 9, 0, 0, 0, 6, 15
"d:\vscodeproject\Cyuyan\.VSCodeCounter\2024-05-20_23-33-24\diff.md", "Markdown", 12, 0, 0, 0, 7, 19
"d:\vscodeproject\Cyuyan\.VSCodeCounter\2024-05-20_23-33-24\results.json", "JSON", 0, 0, 1, 0, 0, 1
"d:\vscodeproject\Cyuyan\.VSCodeCounter\2024-05-20_23-33-24\results.md", "Markdown", 36, 0, 0, 0, 7, 43
"d:\vscodeproject\Cyuyan\C_test_project\3_character_string\test.c", "C", 0, 1, 0, 0, 0, 1
"d:\vscodeproject\Cyuyan\C_test_project\4_Branch\practice_jishu.c", "C", 0, -15, 0, -1, 0, -16
"d:\vscodeproject\Cyuyan\C_test_project\4_Branch\tes.c", "C", 0, 74, 0, 33, 0, 107
"d:\vscodeproject\Cyuyan\C_test_project\4_Branch\test.c", "C", 0, -33, 0, -24, 0, -57
"d:\vscodeproject\Cyuyan\C_test_project\4_Branch\错误发现.md", "Markdown", 1, 0, 0, 0, 0, 1
"d:\vscodeproject\Cyuyan\C_test_project\5_loop_statement\course\main.c", "C", 0, 44, 0, 34, 2, 80
"d:\vscodeproject\Cyuyan\C_test_project\5_loop_statement\main.c", "C", 0, -4, 0, 0, 0, -4
"d:\vscodeproject\Cyuyan\C_test_project\5_loop_statement\practice\lian.c", "C", 0, 24, 0, 9, 1, 34
"d:\vscodeproject\Cyuyan\README.md", "Markdown", 42, 0, 0, 0, 12, 54
"d:\vscodeproject\Cyuyan\leetcode\2.两数相加.c", "C", 0, 31, 0, 14, 2, 47
"d:\vscodeproject\Cyuyan\leetcode\4.寻找两个正序数组的中位数.c", "C", 0, 64, 0, 15, 2, 81
"d:\vscodeproject\Cyuyan\leetcode\5.最长回文子串.c", "C", 0, 47, 0, 9, 2, 58
"d:\vscodeproject\Cyuyan\leetcode\6.z-字形变换.c", "C", 0, 2, 0, 10, 4, 16
"d:\vscodeproject\Cyuyan\leetcode\9.回文数.c", "C", 0, -3, 0, 0, 0, -3
"d:\vscodeproject\Cyuyan\leetcode_project_exercise\leetcode_9_isPalindrome\huiwen.c", "C", 0, -1, 0, 0, 0, -1
"d:\vscodeproject\Cyuyan\leetcode_project_exercise\leetcode_9_isPalindrome\huiwen1.c", "C", 0, 1, 0, 0, 0, 1
"Total", "-", 139, 232, 1, 99, 51, 522