"filename", "language", "Markdown", "C", "C++", "JSON", "comment", "blank", "total"
"d:\vscodeproject\Cyuyan\.VSCodeCounter\2024-05-20_23-33-24\details.md", "Markdown", 39, 0, 0, 0, 0, 6, 45
"d:\vscodeproject\Cyuyan\.VSCodeCounter\2024-05-20_23-33-24\diff-details.md", "Markdown", 9, 0, 0, 0, 0, 6, 15
"d:\vscodeproject\Cyuyan\.VSCodeCounter\2024-05-20_23-33-24\diff.md", "Markdown", 12, 0, 0, 0, 0, 7, 19
"d:\vscodeproject\Cyuyan\.VSCodeCounter\2024-05-20_23-33-24\results.json", "JSON", 0, 0, 0, 1, 0, 0, 1
"d:\vscodeproject\Cyuyan\.VSCodeCounter\2024-05-20_23-33-24\results.md", "Markdown", 36, 0, 0, 0, 0, 7, 43
"d:\vscodeproject\Cyuyan\C_test_project\10_pointer\p.c", "C", 0, 10, 0, 0, 29, 1, 40
"d:\vscodeproject\Cyuyan\C_test_project\11_struct\st.c", "C", 0, 23, 0, 0, 7, 5, 35
"d:\vscodeproject\Cyuyan\C_test_project\1_datatype\main.c", "C", 0, 12, 0, 0, 2, 0, 14
"d:\vscodeproject\Cyuyan\C_test_project\2_VariablesandConstants\main.c", "C", 0, 18, 0, 0, 17, 2, 37
"d:\vscodeproject\Cyuyan\C_test_project\3_character_string\test.c", "C", 0, 24, 0, 0, 6, 1, 31
"d:\vscodeproject\Cyuyan\C_test_project\4_Branch\tes.c", "C", 0, 74, 0, 0, 33, 0, 107
"d:\vscodeproject\Cyuyan\C_test_project\4_Branch\错误发现.md", "Markdown", 11, 0, 0, 0, 0, 1, 12
"d:\vscodeproject\Cyuyan\C_test_project\5_loop_statement\course\main.c", "C", 0, 44, 0, 0, 34, 2, 80
"d:\vscodeproject\Cyuyan\C_test_project\5_loop_statement\practice\lian.c", "C", 0, 24, 0, 0, 9, 1, 34
"d:\vscodeproject\Cyuyan\C_test_project\6_function\main.c", "C", 0, 31, 0, 0, 1, 1, 33
"d:\vscodeproject\Cyuyan\C_test_project\7_operateor\main.c", "C", 0, 10, 0, 0, 26, 3, 39
"d:\vscodeproject\Cyuyan\C_test_project\8_keyword\add.c", "C", 0, 10, 0, 0, 8, 1, 19
"d:\vscodeproject\Cyuyan\C_test_project\8_keyword\kw.c", "C", 0, 32, 0, 0, 41, 5, 78
"d:\vscodeproject\Cyuyan\C_test_project\9_define_and_macro\dam.c", "C", 0, 11, 0, 0, 2, 0, 13
"d:\vscodeproject\Cyuyan\README.md", "Markdown", 78, 0, 0, 0, 0, 16, 94
"d:\vscodeproject\Cyuyan\data_structure_exercise\Linklist_1\01.c", "C", 0, 9, 0, 0, 0, 2, 11
"d:\vscodeproject\Cyuyan\leetcode\1.两数之和.c", "C", 0, 19, 0, 0, 15, 3, 37
"d:\vscodeproject\Cyuyan\leetcode\2.两数相加.c", "C", 0, 31, 0, 0, 14, 2, 47
"d:\vscodeproject\Cyuyan\leetcode\3.无重复字符的最长子串.c", "C", 0, 27, 0, 0, 9, 1, 37
"d:\vscodeproject\Cyuyan\leetcode\4.寻找两个正序数组的中位数.c", "C", 0, 64, 0, 0, 15, 2, 81
"d:\vscodeproject\Cyuyan\leetcode\5.最长回文子串.c", "C", 0, 47, 0, 0, 9, 2, 58
"d:\vscodeproject\Cyuyan\leetcode\6.z-字形变换.c", "C", 0, 2, 0, 0, 10, 4, 16
"d:\vscodeproject\Cyuyan\leetcode\9.回文数.c", "C", 0, 34, 0, 0, 7, 2, 43
"d:\vscodeproject\Cyuyan\leetcode_project_exercise\leetcode_3_lengthOfLongestSubstring\zui.c", "C", 0, 52, 0, 0, 2, 1, 55
"d:\vscodeproject\Cyuyan\leetcode_project_exercise\leetcode_3_lengthOfLongestSubstring\zui.h", "C++", 0, 0, 1, 0, 0, 0, 1
"d:\vscodeproject\Cyuyan\leetcode_project_exercise\leetcode_3_lengthOfLongestSubstring\zuichangzichuan.c", "C", 0, 10, 0, 0, 0, 0, 10
"d:\vscodeproject\Cyuyan\leetcode_project_exercise\leetcode_9_isPalindrome\huiwen.c", "C", 0, 36, 0, 0, 0, 0, 36
"d:\vscodeproject\Cyuyan\leetcode_project_exercise\leetcode_9_isPalindrome\huiwen.h", "C++", 0, 0, 1, 0, 1, 0, 2
"d:\vscodeproject\Cyuyan\leetcode_project_exercise\leetcode_9_isPalindrome\huiwen1.c", "C", 0, 13, 0, 0, 1, 0, 14
"d:\vscodeproject\Cyuyan\test1_hello\hello_world.c", "C", 0, 26, 0, 0, 0, 3, 29
"d:\vscodeproject\Cyuyan\test1_hello\max.c", "C", 0, 7, 0, 0, 0, 0, 7
"d:\vscodeproject\Cyuyan\test1_hello\max.h", "C++", 0, 0, 1, 0, 0, 0, 1
"d:\vscodeproject\Cyuyan\test1_hello\min.c", "C", 0, 7, 0, 0, 0, 0, 7
"d:\vscodeproject\Cyuyan\test1_hello\min.h", "C++", 0, 0, 1, 0, 0, 0, 1
"Total", "-", 185, 707, 4, 1, 298, 87, 1282