"filename", "language", "Markdown", "C", "C++", "comment", "blank", "total"
"d:\vscodeproject\Cyuyan\C_test_project\10_pointer\p.c", "C", 0, 10, 0, 29, 1, 40
"d:\vscodeproject\Cyuyan\C_test_project\11_struct\st.c", "C", 0, 23, 0, 7, 5, 35
"d:\vscodeproject\Cyuyan\C_test_project\1_datatype\main.c", "C", 0, 12, 0, 2, 0, 14
"d:\vscodeproject\Cyuyan\C_test_project\2_VariablesandConstants\main.c", "C", 0, 18, 0, 17, 2, 37
"d:\vscodeproject\Cyuyan\C_test_project\3_character_string\test.c", "C", 0, 23, 0, 6, 1, 30
"d:\vscodeproject\Cyuyan\C_test_project\4_Branch\practice_jishu.c", "C", 0, 15, 0, 1, 0, 16
"d:\vscodeproject\Cyuyan\C_test_project\4_Branch\test.c", "C", 0, 33, 0, 24, 0, 57
"d:\vscodeproject\Cyuyan\C_test_project\4_Branch\错误发现.md", "Markdown", 10, 0, 0, 0, 1, 11
"d:\vscodeproject\Cyuyan\C_test_project\5_loop_statement\main.c", "C", 0, 4, 0, 0, 0, 4
"d:\vscodeproject\Cyuyan\C_test_project\6_function\main.c", "C", 0, 31, 0, 1, 1, 33
"d:\vscodeproject\Cyuyan\C_test_project\7_operateor\main.c", "C", 0, 10, 0, 26, 3, 39
"d:\vscodeproject\Cyuyan\C_test_project\8_keyword\add.c", "C", 0, 10, 0, 8, 1, 19
"d:\vscodeproject\Cyuyan\C_test_project\8_keyword\kw.c", "C", 0, 32, 0, 41, 5, 78
"d:\vscodeproject\Cyuyan\C_test_project\9_define_and_macro\dam.c", "C", 0, 11, 0, 2, 0, 13
"d:\vscodeproject\Cyuyan\README.md", "Markdown", 36, 0, 0, 0, 4, 40
"d:\vscodeproject\Cyuyan\data_structure_exercise\Linklist_1\01.c", "C", 0, 9, 0, 0, 2, 11
"d:\vscodeproject\Cyuyan\leetcode\1.两数之和.c", "C", 0, 19, 0, 15, 3, 37
"d:\vscodeproject\Cyuyan\leetcode\3.无重复字符的最长子串.c", "C", 0, 27, 0, 9, 1, 37
"d:\vscodeproject\Cyuyan\leetcode\9.回文数.c", "C", 0, 37, 0, 7, 2, 46
"d:\vscodeproject\Cyuyan\leetcode_project_exercise\leetcode_3_lengthOfLongestSubstring\zui.c", "C", 0, 52, 0, 2, 1, 55
"d:\vscodeproject\Cyuyan\leetcode_project_exercise\leetcode_3_lengthOfLongestSubstring\zui.h", "C++", 0, 0, 1, 0, 0, 1
"d:\vscodeproject\Cyuyan\leetcode_project_exercise\leetcode_3_lengthOfLongestSubstring\zuichangzichuan.c", "C", 0, 10, 0, 0, 0, 10
"d:\vscodeproject\Cyuyan\leetcode_project_exercise\leetcode_9_isPalindrome\huiwen.c", "C", 0, 37, 0, 0, 0, 37
"d:\vscodeproject\Cyuyan\leetcode_project_exercise\leetcode_9_isPalindrome\huiwen.h", "C++", 0, 0, 1, 1, 0, 2
"d:\vscodeproject\Cyuyan\leetcode_project_exercise\leetcode_9_isPalindrome\huiwen1.c", "C", 0, 12, 0, 1, 0, 13
"d:\vscodeproject\Cyuyan\test1_hello\hello_world.c", "C", 0, 26, 0, 0, 3, 29
"d:\vscodeproject\Cyuyan\test1_hello\max.c", "C", 0, 7, 0, 0, 0, 7
"d:\vscodeproject\Cyuyan\test1_hello\max.h", "C++", 0, 0, 1, 0, 0, 1
"d:\vscodeproject\Cyuyan\test1_hello\min.c", "C", 0, 7, 0, 0, 0, 7
"d:\vscodeproject\Cyuyan\test1_hello\min.h", "C++", 0, 0, 1, 0, 0, 1
"Total", "-", 46, 475, 4, 199, 36, 760