"filename", "language", "Markdown", "C", "C++", "JSON", "comment", "blank", "total"
"d:\vscodeproject\Cyuyan\.VSCodeCounter\2024-06-05_00-23-24\details.md", "Markdown", 48, 0, 0, 0, 0, 6, 54
"d:\vscodeproject\Cyuyan\.VSCodeCounter\2024-06-05_00-23-24\diff-details.md", "Markdown", 30, 0, 0, 0, 0, 6, 36
"d:\vscodeproject\Cyuyan\.VSCodeCounter\2024-06-05_00-23-24\diff.md", "Markdown", 29, 0, 0, 0, 0, 7, 36
"d:\vscodeproject\Cyuyan\.VSCodeCounter\2024-06-05_00-23-24\results.json", "JSON", 0, 0, 0, 1, 0, 0, 1
"d:\vscodeproject\Cyuyan\.VSCodeCounter\2024-06-05_00-23-24\results.md", "Markdown", 41, 0, 0, 0, 0, 7, 48
"d:\vscodeproject\Cyuyan\C_test_project\10_define_and_macro\dam.c", "C", 0, 11, 0, 0, 2, 0, 13
"d:\vscodeproject\Cyuyan\C_test_project\10_pointer\p.c", "C", 0, -10, 0, 0, -29, -1, -40
"d:\vscodeproject\Cyuyan\C_test_project\11_pointer\course\p.c", "C", 0, 10, 0, 0, 29, 1, 40
"d:\vscodeproject\Cyuyan\C_test_project\11_pointer\practice\practice.c", "C", 0, 54, 0, 0, 8, 0, 62
"d:\vscodeproject\Cyuyan\C_test_project\11_struct\st.c", "C", 0, -23, 0, 0, -7, -5, -35
"d:\vscodeproject\Cyuyan\C_test_project\12_struct\st.c", "C", 0, 23, 0, 0, 7, 5, 35
"d:\vscodeproject\Cyuyan\C_test_project\5_loop_statement\game\猜数字.c", "C", 0, 61, 0, 0, 9, 0, 70
"d:\vscodeproject\Cyuyan\C_test_project\5_loop_statement\practice1\lian.c", "C", 0, 184, 0, 0, 23, 0, 207
"d:\vscodeproject\Cyuyan\C_test_project\5_loop_statement\practice2\practice.c", "C", 0, 67, 0, 0, 11, 1, 79
"d:\vscodeproject\Cyuyan\C_test_project\5_loop_statement\practice\lian.c", "C", 0, -24, 0, 0, -9, -1, -34
"d:\vscodeproject\Cyuyan\C_test_project\6_function\course\MAX.c", "C", 0, 11, 0, 0, 0, 0, 11
"d:\vscodeproject\Cyuyan\C_test_project\6_function\course\Max.h", "C++", 0, 0, 4, 0, 1, 0, 5
"d:\vscodeproject\Cyuyan\C_test_project\6_function\course\main.c", "C", 0, 26, 0, 0, 19, 1, 46
"d:\vscodeproject\Cyuyan\C_test_project\6_function\main.c", "C", 0, -31, 0, 0, -1, -1, -33
"d:\vscodeproject\Cyuyan\C_test_project\6_function\practice1\practice.c", "C", 0, 116, 0, 0, 14, 3, 133
"d:\vscodeproject\Cyuyan\C_test_project\7_array\course\main.c", "C", 0, 65, 0, 0, 20, 5, 90
"d:\vscodeproject\Cyuyan\C_test_project\7_array\game1_三字棋\game.c", "C", 0, 247, 0, 0, 18, 3, 268
"d:\vscodeproject\Cyuyan\C_test_project\7_array\game1_三字棋\game.h", "C++", 0, 0, 16, 0, 1, 0, 17
"d:\vscodeproject\Cyuyan\C_test_project\7_array\game1_三字棋\test.c", "C", 0, 73, 0, 0, 1, 1, 75
"d:\vscodeproject\Cyuyan\C_test_project\7_operateor\main.c", "C", 0, -10, 0, 0, -26, -3, -39
"d:\vscodeproject\Cyuyan\C_test_project\8_keyword\add.c", "C", 0, -10, 0, 0, -8, -1, -19
"d:\vscodeproject\Cyuyan\C_test_project\8_keyword\kw.c", "C", 0, -32, 0, 0, -41, -5, -78
"d:\vscodeproject\Cyuyan\C_test_project\8_operateor\main.c", "C", 0, 10, 0, 0, 26, 3, 39
"d:\vscodeproject\Cyuyan\C_test_project\9_define_and_macro\dam.c", "C", 0, -11, 0, 0, -2, 0, -13
"d:\vscodeproject\Cyuyan\C_test_project\9_keyword\add.c", "C", 0, 10, 0, 0, 8, 1, 19
"d:\vscodeproject\Cyuyan\C_test_project\9_keyword\kw.c", "C", 0, 32, 0, 0, 41, 5, 78
"d:\vscodeproject\Cyuyan\README.md", "Markdown", 0, 0, 0, 0, 0, -1, -1
"d:\vscodeproject\Cyuyan\leetcode\121.买卖股票的最佳时机.c", "C", 0, 18, 0, 0, 9, 3, 30
"d:\vscodeproject\Cyuyan\leetcode\26.删除有序数组中的重复项.c", "C", 0, 13, 0, 0, 7, 3, 23
"d:\vscodeproject\Cyuyan\leetcode\27.移除元素.c", "C", 0, 26, 0, 0, 11, 4, 41
"d:\vscodeproject\Cyuyan\leetcode\509.斐波那契数.c", "C", 0, 13, 0, 0, 8, 5, 26
"d:\vscodeproject\Cyuyan\leetcode\80.删除有序数组中的重复项-ii.c", "C", 0, 25, 0, 0, 13, 3, 41
"d:\vscodeproject\Cyuyan\leetcode\88.合并两个有序数组.c", "C", 0, 54, 0, 0, 11, 2, 67
"Total", "-", 148, 998, 20, 1, 174, 57, 1398