"filename", "language", "C++", "C", "Markdown", "JSON", "comment", "blank", "total"
"d:\vscodeproject\Cyuyan\.VSCodeCounter\2024-05-20_23-33-24\details.md", "Markdown", 0, 0, 39, 0, 0, 6, 45
"d:\vscodeproject\Cyuyan\.VSCodeCounter\2024-05-20_23-33-24\diff-details.md", "Markdown", 0, 0, 9, 0, 0, 6, 15
"d:\vscodeproject\Cyuyan\.VSCodeCounter\2024-05-20_23-33-24\diff.md", "Markdown", 0, 0, 12, 0, 0, 7, 19
"d:\vscodeproject\Cyuyan\.VSCodeCounter\2024-05-20_23-33-24\results.json", "JSON", 0, 0, 0, 1, 0, 0, 1
"d:\vscodeproject\Cyuyan\.VSCodeCounter\2024-05-20_23-33-24\results.md", "Markdown", 0, 0, 36, 0, 0, 7, 43
"d:\vscodeproject\Cyuyan\.VSCodeCounter\2024-06-05_00-23-24\details.md", "Markdown", 0, 0, 48, 0, 0, 6, 54
"d:\vscodeproject\Cyuyan\.VSCodeCounter\2024-06-05_00-23-24\diff-details.md", "Markdown", 0, 0, 30, 0, 0, 6, 36
"d:\vscodeproject\Cyuyan\.VSCodeCounter\2024-06-05_00-23-24\diff.md", "Markdown", 0, 0, 29, 0, 0, 7, 36
"d:\vscodeproject\Cyuyan\.VSCodeCounter\2024-06-05_00-23-24\results.json", "JSON", 0, 0, 0, 1, 0, 0, 1
"d:\vscodeproject\Cyuyan\.VSCodeCounter\2024-06-05_00-23-24\results.md", "Markdown", 0, 0, 41, 0, 0, 7, 48
"d:\vscodeproject\Cyuyan\C_test_project\10_define_and_macro\dam.c", "C", 0, 11, 0, 0, 2, 0, 13
"d:\vscodeproject\Cyuyan\C_test_project\11_pointer\course\p.c", "C", 0, 10, 0, 0, 29, 1, 40
"d:\vscodeproject\Cyuyan\C_test_project\11_pointer\practice\practice.c", "C", 0, 54, 0, 0, 8, 0, 62
"d:\vscodeproject\Cyuyan\C_test_project\12_struct\st.c", "C", 0, 23, 0, 0, 7, 5, 35
"d:\vscodeproject\Cyuyan\C_test_project\1_datatype\main.c", "C", 0, 12, 0, 0, 2, 0, 14
"d:\vscodeproject\Cyuyan\C_test_project\2_VariablesandConstants\main.c", "C", 0, 18, 0, 0, 17, 2, 37
"d:\vscodeproject\Cyuyan\C_test_project\3_character_string\test.c", "C", 0, 24, 0, 0, 6, 1, 31
"d:\vscodeproject\Cyuyan\C_test_project\4_Branch\tes.c", "C", 0, 74, 0, 0, 33, 0, 107
"d:\vscodeproject\Cyuyan\C_test_project\4_Branch\错误发现.md", "Markdown", 0, 0, 11, 0, 0, 1, 12
"d:\vscodeproject\Cyuyan\C_test_project\5_loop_statement\course\main.c", "C", 0, 44, 0, 0, 34, 2, 80
"d:\vscodeproject\Cyuyan\C_test_project\5_loop_statement\game\猜数字.c", "C", 0, 61, 0, 0, 9, 0, 70
"d:\vscodeproject\Cyuyan\C_test_project\5_loop_statement\practice1\lian.c", "C", 0, 184, 0, 0, 23, 0, 207
"d:\vscodeproject\Cyuyan\C_test_project\5_loop_statement\practice2\practice.c", "C", 0, 67, 0, 0, 11, 1, 79
"d:\vscodeproject\Cyuyan\C_test_project\6_function\course\MAX.c", "C", 0, 11, 0, 0, 0, 0, 11
"d:\vscodeproject\Cyuyan\C_test_project\6_function\course\Max.h", "C++", 4, 0, 0, 0, 1, 0, 5
"d:\vscodeproject\Cyuyan\C_test_project\6_function\course\main.c", "C", 0, 26, 0, 0, 19, 1, 46
"d:\vscodeproject\Cyuyan\C_test_project\6_function\practice1\practice.c", "C", 0, 116, 0, 0, 14, 3, 133
"d:\vscodeproject\Cyuyan\C_test_project\7_array\course\main.c", "C", 0, 65, 0, 0, 20, 5, 90
"d:\vscodeproject\Cyuyan\C_test_project\7_array\game1_三字棋\game.c", "C", 0, 247, 0, 0, 18, 3, 268
"d:\vscodeproject\Cyuyan\C_test_project\7_array\game1_三字棋\game.h", "C++", 16, 0, 0, 0, 1, 0, 17
"d:\vscodeproject\Cyuyan\C_test_project\7_array\game1_三字棋\test.c", "C", 0, 73, 0, 0, 1, 1, 75
"d:\vscodeproject\Cyuyan\C_test_project\8_operateor\main.c", "C", 0, 10, 0, 0, 26, 3, 39
"d:\vscodeproject\Cyuyan\C_test_project\9_keyword\add.c", "C", 0, 10, 0, 0, 8, 1, 19
"d:\vscodeproject\Cyuyan\C_test_project\9_keyword\kw.c", "C", 0, 32, 0, 0, 41, 5, 78
"d:\vscodeproject\Cyuyan\README.md", "Markdown", 0, 0, 78, 0, 0, 15, 93
"d:\vscodeproject\Cyuyan\data_structure_exercise\Linklist_1\01.c", "C", 0, 9, 0, 0, 0, 2, 11
"d:\vscodeproject\Cyuyan\leetcode\1.两数之和.c", "C", 0, 19, 0, 0, 15, 3, 37
"d:\vscodeproject\Cyuyan\leetcode\121.买卖股票的最佳时机.c", "C", 0, 18, 0, 0, 9, 3, 30
"d:\vscodeproject\Cyuyan\leetcode\2.两数相加.c", "C", 0, 31, 0, 0, 14, 2, 47
"d:\vscodeproject\Cyuyan\leetcode\26.删除有序数组中的重复项.c", "C", 0, 13, 0, 0, 7, 3, 23
"d:\vscodeproject\Cyuyan\leetcode\27.移除元素.c", "C", 0, 26, 0, 0, 11, 4, 41
"d:\vscodeproject\Cyuyan\leetcode\3.无重复字符的最长子串.c", "C", 0, 27, 0, 0, 9, 1, 37
"d:\vscodeproject\Cyuyan\leetcode\4.寻找两个正序数组的中位数.c", "C", 0, 64, 0, 0, 15, 2, 81
"d:\vscodeproject\Cyuyan\leetcode\5.最长回文子串.c", "C", 0, 47, 0, 0, 9, 2, 58
"d:\vscodeproject\Cyuyan\leetcode\509.斐波那契数.c", "C", 0, 13, 0, 0, 8, 5, 26
"d:\vscodeproject\Cyuyan\leetcode\6.z-字形变换.c", "C", 0, 2, 0, 0, 10, 4, 16
"d:\vscodeproject\Cyuyan\leetcode\80.删除有序数组中的重复项-ii.c", "C", 0, 25, 0, 0, 13, 3, 41
"d:\vscodeproject\Cyuyan\leetcode\88.合并两个有序数组.c", "C", 0, 54, 0, 0, 11, 2, 67
"d:\vscodeproject\Cyuyan\leetcode\9.回文数.c", "C", 0, 34, 0, 0, 7, 2, 43
"d:\vscodeproject\Cyuyan\leetcode_project_exercise\leetcode_3_lengthOfLongestSubstring\zui.c", "C", 0, 52, 0, 0, 2, 1, 55
"d:\vscodeproject\Cyuyan\leetcode_project_exercise\leetcode_3_lengthOfLongestSubstring\zui.h", "C++", 1, 0, 0, 0, 0, 0, 1
"d:\vscodeproject\Cyuyan\leetcode_project_exercise\leetcode_3_lengthOfLongestSubstring\zuichangzichuan.c", "C", 0, 10, 0, 0, 0, 0, 10
"d:\vscodeproject\Cyuyan\leetcode_project_exercise\leetcode_9_isPalindrome\huiwen.c", "C", 0, 36, 0, 0, 0, 0, 36
"d:\vscodeproject\Cyuyan\leetcode_project_exercise\leetcode_9_isPalindrome\huiwen.h", "C++", 1, 0, 0, 0, 1, 0, 2
"d:\vscodeproject\Cyuyan\leetcode_project_exercise\leetcode_9_isPalindrome\huiwen1.c", "C", 0, 13, 0, 0, 1, 0, 14
"d:\vscodeproject\Cyuyan\test1_hello\hello_world.c", "C", 0, 26, 0, 0, 0, 3, 29
"d:\vscodeproject\Cyuyan\test1_hello\max.c", "C", 0, 7, 0, 0, 0, 0, 7
"d:\vscodeproject\Cyuyan\test1_hello\max.h", "C++", 1, 0, 0, 0, 0, 0, 1
"d:\vscodeproject\Cyuyan\test1_hello\min.c", "C", 0, 7, 0, 0, 0, 0, 7
"d:\vscodeproject\Cyuyan\test1_hello\min.h", "C++", 1, 0, 0, 0, 0, 0, 1
"Total", "-", 24, 1705, 333, 2, 472, 144, 2680